56 15
512 650
300 300 300 300 300 300 300 300 300 300 301 300 300 300 300 300 300 301 300 300 301 300 300 300 300 300 300 300 300 300 301 300 300 300 300 300 300 300 300 300 300 300 300 300 300 300 300 300 300 300 300 300 300 300 300 300
300 300 300 300 300 300 300 300 300 300 301 300 300 300 300 300 300 301 300 300 301 300 300 300 300 300 300 300 300 300 301 300 300 300 300 300 300 300 300 300 300 300 300 300 300 300 300 300 300 300 300 300 300 300 300 300
300 300 300 300 300 300 300 300 300 300 301 300 300 300 300 300 300 301 300 300 301 300 300 300 300 300 300 300 300 300 301 300 300 300 300 300 300 300 300 300 300 300 300 300 300 300 300 300 300 300 300 300 300 300 300 300
300 300 300 300 300 300 300 300 300 300 301 300 300 300 300 300 300 301 300 300 301 300 300 300 300 300 300 300 300 300 301 300 300 300 300 300 300 300 300 300 300 300 300 300 300 300 300 300 300 300 300 300 300 300 300 300
300 300 300 300 300 301 301 301 301 301 301 300 300 300 300 300 300 301 301 301 301 300 300 300 300 300 300 300 300 300 301 300 300 300 300 300 300 300 300 300 300 300 300 300 300 300 300 300 300 300 300 300 300 300 300 300
300 300 300 300 300 301 300 300 300 300 300 300 300 300 300 300 300 300 300 300 300 300 300 300 300 300 300 300 300 300 301 301 301 301 301 301 301 301 301 301 301 301 301 301 301 301 301 301 301 301 301 301 301 301 301 300
300 300 300 300 300 301 300 300 300 300 300 300 300 300 300 300 300 300 300 300 300 300 300 300 300 300 300 300 300 300 300 300 300 300 300 300 300 300 300 300 300 300 300 300 300 300 300 300 300 300 300 300 300 300 301 300
300 300 300 300 300 301 300 300 300 300 300 300 300 300 300 300 300 300 300 300 300 300 300 300 300 300 300 300 300 300 300 300 300 300 300 300 300 300 300 300 300 300 300 300 300 300 300 300 300 300 300 300 300 300 301 300
300 300 300 300 300 301 300 300 300 300 300 300 301 301 301 301 300 300 300 300 300 300 300 300 300 301 301 301 301 301 301 301 301 301 301 301 301 301 301 301 301 301 301 301 301 301 301 301 301 301 301 301 301 301 301 300
300 300 300 300 300 301 300 300 300 300 300 300 300 300 300 300 300 300 300 300 300 300 300 300 300 301 300 300 300 300 300 300 300 300 300 300 300 300 300 300 300 300 300 300 300 300 300 300 300 300 300 300 300 300 300 300
300 300 300 300 300 301 300 300 300 300 300 300 300 300 300 300 300 300 300 300 300 300 300 300 300 301 300 300 300 300 300 300 300 300 300 300 300 300 300 300 300 300 300 300 300 300 300 300 300 300 300 300 300 300 300 300
300 301 301 301 301 301 300 300 300 300 300 300 300 300 300 300 300 300 300 301 301 301 301 300 300 301 301 301 301 301 301 301 300 300 300 300 300 300 300 300 300 300 300 300 300 300 300 300 300 300 300 300 300 300 300 300
300 301 300 300 300 300 300 300 300 300 300 300 300 300 300 300 300 300 300 300 300 300 300 300 300 300 300 300 300 300 300 301 300 300 300 300 300 300 300 300 300 300 300 300 300 300 300 300 300 300 300 300 300 300 300 300
300 301 300 300 300 300 300 300 300 300 300 300 300 300 300 300 300 300 300 300 300 300 300 300 300 300 300 300 300 300 300 301 300 300 300 300 300 300 300 300 300 300 300 300 300 300 300 300 300 300 300 300 300 300 300 300
300 301 301 301 301 301 301 301 301 301 301 301 301 301 301 301 301 301 301 301 301 301 301 301 301 301 301 301 301 301 301 301 300 300 300 300 300 300 300 300 300 300 300 300 300 300 300 300 300 300 300 300 300 300 300 300
